EEEEEFFRNNNNNLFFEEEEEEEEEE
BBBBBBBKNNNNNJBBEEEEEEEEEE
NNNNNNNNNNNNNNJJBBBBBBBBBB
NNNNNNNNNNNNNNNNNNNNNNNNNN
NNNNNNNN2WWW1NNNNNNNNNNNNN
NNNNNNNN3BFEFDNNNN1NNNNNNN
NNNNNNNNN5LERNNNNNPNNNNNNN
NNNNNNNNN5LERNNNNNUDNNNNNN
NNNNNNNNN5LERNNNNNNNNNNNNN
NNNNNNNNN5LERNNNNNNNNNNNNN
NNNNNNNNN5LERNNNNNNNNNNNNN
NNNNNNNNN5LERNNNNNNNNNNNNN
NNNNNNNNN5JBKNNNNNNNNNNCQD
NNNNNNNNNNNNNNNNNNNNNNNNNN
WWWWW1NNNNNNNNNNNNNCQDNNNN
EEEFFRNNNNNNNCQDNNNNNNNNNN
EEEEFRNNNNNNNNNNNNNNNNNNNN
EEEEERSSSSSSSSSSSSSSSSSSSS