EEEEEEEEEEFFRNNNNNNLFEEEEE
EEEEEEEEEFBBKNNNNNNJFEEEEE
EEEEEEEEFRNNNNNNNNNNLFEEEE
EEEEEEEFBKNNNNNNNNNNJBFFEE
EFBFEEFRNNNNNNNNNNNNNNJBFE
BKNJFFFRNNNNNNNNNNNNNNNNJE
NNNNJBFFWW1NNNNNNNNNNNNNNL
NNNNNNLFFFRNNNSSSNNNNNNNNL
NNNNNNJBBBBQQTTQDNNNNNNNNL
NNNNNNNNNNNNNJKNNNNNNN2WWE	
NNNNNNNNNNNNNNNNNNNNNNLFFE
NNNNNNNNNNNNNNNNNNNNNNLFEE
NNNNNNNNNNNNNSSSSNNNNNLFEE
NNNNNNNNNNNCQTTQDNNNNNLEEE
WWWW1NNNNNNNNLRNNNNNNNLEEE
EEFFRNNNNNNNNLRNNNNNNNLEEE
EEEFRNNIHNNNNLRNNNNN2WFEEE
EEEERSSLRSSSSLRSSSSSLFEEEE