EEEERNNNNNNLFEEEEEEEEEEEEE
EEEERNNNNNNLFFBBBBBBFFEEEE
EEEERNNNNNNLNNNNNNNNJBBBFE
EEEERNNNNNNPNNNNNNNNNNNNJB
EEEERSNNNNNPNSNNNNNNNNNNNN
EEEEF1NNNNNUNUNNNNNNNNNNNN
EEEEFRNNNNNNNNNNNNNNSNNNNN
EEEFFRNNNNNNNNSNNNNN21NNNN
BBBBBRSSSNN1NNCDNNNSLRNNNN
NNNNNJQQDNNUNNNNNNNCFRNNNN
NNNNNNNNNNNNNNNNNNNNJKNNNN
NNNNNNNNNNNNNNNNNNNNNNCDNN
NNNNNNNNNNNNNNNNNNNNNNNNNN
NNNNNNNNNNNNNNNNNNNNNNNNNN
NNNNNNNNNNNNNNNNNNNNNNNNNN
NN21NNNNCQQDNNNCQQDNNNNNNN
NNLRNNNNNNNNNNNNNNNNNNNNNN
SSLRSSSSSSSSSSSSSSSSSSSSSS