EEEEEEEEEEEEEEEEEFFFRNNNLF
EEEEEEEEEFFBBBBBBBBBKNNNLF
EEEFFBBBBBKNNNNNNNNNNNNNLE
EFFFKNNNNNNNNNNNNNNNNNNNLE
EFBKNNNNNNNNNNNNNNNNNN2WFE
ERNNNNNNNNNNNNNNNNNNCQQFFE
FRNNNNNNNNNNNNNNNNNNNNNJFE
FFQQQQQDNNNNNNNNNNNNNNNNLE
FKNNNNNNNNNNNNNNNNNNNNNNLE
RNNNNNNNNNNNNNNNNNNNNNNNLE
KNNNNNNNNNNNNNNNNNNNNCQTFE
NNNNNNNNNNNNNNNNNNNNNNNLFE
NNNNNNNNNNN2WW1NNNNNNNNLEE
NNNNNNNNNNNLFFRNNNNNNNNLEE
NNNNN2W1NNNLEERNNNSSSSSLEE
WWWWWFERNNNLEERSSSITTTTFEE
EEEEEEERSSSLEEFTTTFEEEEEEE
EEEEEEEFTTTFEEEEEEEEEEEEEE