EEEEEEEEEEEEEEEFFFRNNNNNLF
EEEEEEEFFBBBBBBBFFRNNNNNLF
EEEEFFBBKNNNNNNNLFRNNNNNLE
EEEFFKNNNNNNNNNNLFRNNNNNLE
EEEFRNNNNNNNNNNNLFKNNNNNLE
EEEFRNNNNNNNNNNNLRNNNNNNLE
EFBBKNNNNNNSSNNNJKNNNNNNLE
ERNNNNNNNNNIHNNNNNNNNN2WFE
EFWWW1NNNNNLRNNNNNNNNNLFEE
EEFFFRNNNNNLRNNNNNNNNNLEEE
EEEEFRNNNNNLRNNNNNNNNNLFEE
EEEEERNNNNNLRNNNNNNNNCBBFE
BBBFFRNNNNNLRNNNNNNNNNNNLF
NNNJBRNNNNNLRNNNNNNNNNNNJB
NNNNNUNNNNNLRSSSSSNNNNNNNN
NNNNNNNNNNNLFTTTTTNNNNNNNN
WWWWWWWWWWWFFFFFFRNNNNNNNN
EEEEEEEEEEEEEEEEFRSSSSSSSS